8 6 
# # # # # #
# * * * . #
# * * * . #
# * * * . #
# . . . . #
# . . . . #
# . . . x #
# # # # # #